"","fish_id","bin","LLLL","LLLR","LLRL","LLRR","LRLL","LRLR","LRRL","LRRR","RLLL","RLLR","RLRL","RLRR","RRLL","RRLR","RRRL","RRRR","L","R","total_turns","reps","alts","rel_reps","rel_alts","rel_R","rel_L"
"1","1","1",3,4,10,5,10,69,10,14,4,11,69,19,6,18,14,14,127,156,283,17,138,6.00706713780919,48.7632508833922,55.1236749116608,44.8763250883392
"2","1","2",7,4,8,5,9,15,9,7,4,9,16,11,5,12,7,4,66,69,135,11,31,8.14814814814815,22.962962962963,51.1111111111111,48.8888888888889
"3","1","3",3,4,5,5,6,7,7,6,4,6,8,9,4,9,6,5,44,53,97,8,15,8.24742268041237,15.4639175257732,54.639175257732,45.360824742268
"4","1","4",2,1,1,3,3,2,2,5,1,3,5,4,1,7,5,3,21,30,51,5,7,9.80392156862745,13.7254901960784,58.8235294117647,41.1764705882353
"5","1","5",0,1,0,3,0,0,2,2,0,2,1,1,2,2,2,0,10,11,21,0,1,0,4.76190476190476,52.3809523809524,47.6190476190476
"6","1","6",0,0,1,1,1,1,0,2,0,1,1,1,0,2,2,1,7,10,17,1,2,5.88235294117647,11.7647058823529,58.8235294117647,41.1764705882353
"7","100","1",18,6,7,10,8,8,9,6,6,11,9,5,9,6,6,3,72,58,130,21,17,16.1538461538462,13.0769230769231,44.6153846153846,55.3846153846154
"8","100","2",0,1,0,3,0,3,4,1,1,2,3,2,3,2,1,0,14,15,29,0,6,0,20.6896551724138,51.7241379310345,48.2758620689655
"9","100","3",1,2,3,2,3,8,3,4,3,3,8,4,3,4,4,3,29,32,61,4,16,6.55737704918033,26.2295081967213,52.4590163934426,47.5409836065574
"10","100","4",0,1,2,2,3,4,1,4,1,3,5,3,1,4,4,10,17,34,51,10,9,19.6078431372549,17.6470588235294,66.6666666666667,33.3333333333333
"11","100","5",0,0,1,0,0,2,4,2,0,2,1,5,2,4,2,2,11,19,30,2,3,6.66666666666667,10,63.3333333333333,36.6666666666667
"12","100","6",1,1,1,2,1,2,5,3,0,2,2,6,1,6,2,2,16,24,40,3,4,7.5,10,60,40
"13","101","1",6,7,12,8,14,577,12,5,7,13,579,9,6,11,5,5,643,636,1279,11,1156,0.860046911649726,90.3831118060985,49.7263487099296,50.2736512900704
"14","101","2",0,0,0,0,0,218,0,0,0,0,219,0,0,0,0,0,220,220,440,0,437,0,99.3181818181818,50,50
"15","101","3",0,0,0,0,0,73,0,0,0,0,74,0,0,0,0,0,75,75,150,0,147,0,98,50,50
"16","101","4",0,0,0,0,0,113,0,0,0,0,114,0,0,0,0,0,115,115,230,0,227,0,98.695652173913,50,50
"17","101","5",0,0,0,0,0,63,0,0,0,0,64,0,0,0,0,0,65,65,130,0,127,0,97.6923076923077,50,50
"18","101","6",0,0,0,0,0,46,0,0,0,0,46,0,0,0,0,0,47,48,95,0,92,0,96.8421052631579,50.5263157894737,49.4736842105263
"19","102","1",0,0,0,0,0,618,0,0,0,0,617,0,0,0,0,0,619,619,1238,0,1235,0,99.7576736672052,50,50
"20","102","2",0,0,0,0,0,0,0,0,0,0,0,0,0,0,0,0,0,0,0,0,0,NA,NA,NA,NA
"21","102","3",0,0,0,0,0,0,0,0,0,0,0,0,0,0,0,0,0,0,0,0,0,NA,NA,NA,NA
"22","102","4",0,0,0,0,0,0,0,0,0,0,0,0,0,0,0,0,0,0,0,0,0,NA,NA,NA,NA
"23","102","5",0,0,0,0,0,0,0,0,0,0,0,0,0,0,0,0,0,0,0,0,0,NA,NA,NA,NA
"24","102","6",0,0,0,0,0,0,0,0,0,0,0,0,0,0,0,0,0,0,0,0,0,NA,NA,NA,NA
"25","13","1",1,2,2,2,1,4,1,5,2,2,4,4,2,4,5,20,20,44,64,21,8,32.8125,12.5,68.75,31.25
"26","13","2",4,4,3,4,4,5,4,3,4,4,6,3,3,4,3,3,33,31,64,7,11,10.9375,17.1875,48.4375,51.5625
"27","13","3",0,0,0,0,0,0,1,4,0,0,0,5,1,5,5,25,7,42,49,25,0,51.0204081632653,0,85.7142857142857,14.2857142857143
"28","13","4",0,0,0,0,0,0,1,4,0,0,0,5,0,5,4,48,5,65,70,48,0,68.5714285714286,0,92.8571428571429,7.14285714285714
"29","13","5",0,0,0,0,0,1,1,4,0,0,1,5,0,4,3,28,6,44,50,28,2,56,4,88,12
"30","13","6",0,0,1,0,0,1,0,4,0,1,0,4,1,3,4,65,6,81,87,65,1,74.7126436781609,1.14942528735632,93.1034482758621,6.89655172413793
"31","14","1",2,6,9,5,8,14,8,8,6,8,13,10,6,10,8,15,61,78,139,17,27,12.2302158273381,19.4244604316547,56.1151079136691,43.8848920863309
"32","14","2",3,4,3,3,2,7,4,4,4,2,6,5,4,3,3,4,30,34,64,7,13,10.9375,20.3125,53.125,46.875
"33","14","3",10,3,4,3,3,2,4,0,3,3,1,1,3,1,0,0,30,14,44,10,3,22.7272727272727,6.81818181818182,31.8181818181818,68.1818181818182
"34","14","4",1,2,1,2,1,6,4,1,2,2,6,3,3,2,1,0,20,20,40,1,12,2.5,30,50,50
"35","14","5",4,2,1,1,3,6,1,0,2,0,8,0,0,1,0,0,20,12,32,4,14,12.5,43.75,37.5,62.5
"36","14","6",8,4,3,3,3,2,3,1,4,1,3,1,2,2,1,1,29,16,45,9,5,20,11.1111111111111,35.5555555555556,64.4444444444444
"37","16","1",9,8,10,6,10,3,5,3,8,8,3,2,5,2,3,1,55,34,89,10,6,11.2359550561798,6.74157303370786,38.2022471910112,61.7977528089888
"38","16","2",0,1,1,4,2,2,4,6,1,3,3,6,2,7,5,18,20,48,68,18,5,26.4705882352941,7.35294117647059,70.5882352941177,29.4117647058824
"39","16","3",0,0,0,1,0,0,0,4,0,1,0,2,1,2,3,22,5,34,39,22,0,56.4102564102564,0,87.1794871794872,12.8205128205128
"40","16","4",0,0,0,0,0,2,1,3,0,0,2,4,0,4,3,14,6,30,36,14,4,38.8888888888889,11.1111111111111,83.3333333333333,16.6666666666667
"41","16","5",0,0,0,0,0,1,0,2,0,0,1,2,0,3,3,8,4,19,23,8,2,34.7826086956522,8.69565217391304,82.6086956521739,17.3913043478261
"42","16","6",0,0,1,0,0,3,1,1,0,1,2,2,1,1,1,7,7,17,24,7,5,29.1666666666667,20.8333333333333,70.8333333333333,29.1666666666667
"43","17","1",9,6,8,0,7,7,0,2,5,3,6,2,1,1,2,3,41,24,65,12,13,18.4615384615385,20,36.9230769230769,63.0769230769231
"44","17","2",3,5,9,5,9,11,5,8,4,9,12,8,4,9,8,10,57,65,122,13,23,10.655737704918,18.8524590163934,53.2786885245902,46.7213114754098
"45","17","3",13,9,8,9,7,8,5,10,9,8,7,6,9,6,10,15,70,72,142,28,15,19.7183098591549,10.5633802816901,50.7042253521127,49.2957746478873
"46","17","4",2,2,2,5,4,7,8,7,2,5,8,10,3,11,6,10,37,58,95,12,15,12.6315789473684,15.7894736842105,61.0526315789474,38.9473684210526
"47","17","5",0,1,1,4,4,8,4,5,1,4,11,5,1,8,6,19,28,57,85,19,19,22.3529411764706,22.3529411764706,67.0588235294118,32.9411764705882
"48","17","6",0,0,1,3,2,3,2,7,0,5,4,6,3,7,8,16,20,50,70,16,7,22.8571428571429,10,71.4285714285714,28.5714285714286
"49","2","1",1,7,4,5,2,6,7,11,7,2,4,13,7,11,11,29,44,86,130,30,10,23.0769230769231,7.69230769230769,66.1538461538462,33.8461538461538
"50","2","2",1,2,4,1,2,13,8,9,2,3,11,15,3,13,8,13,40,71,111,14,24,12.6126126126126,21.6216216216216,63.963963963964,36.036036036036
"51","2","3",0,1,2,3,3,6,4,5,2,4,6,6,3,6,5,18,27,50,77,18,12,23.3766233766234,15.5844155844156,64.9350649350649,35.0649350649351
"52","2","4",0,0,0,3,2,10,2,6,0,3,11,5,1,6,5,10,23,44,67,10,21,14.9253731343284,31.3432835820896,65.6716417910448,34.3283582089552
"53","2","5",0,0,0,1,0,3,1,7,0,1,2,7,1,6,6,13,12,39,51,13,5,25.4901960784314,9.80392156862745,76.4705882352941,23.5294117647059
"54","2","6",0,0,0,1,0,2,0,7,0,1,3,6,1,7,8,19,12,46,58,19,5,32.7586206896552,8.62068965517241,79.3103448275862,20.6896551724138
"55","25","1",5,4,13,3,11,14,8,2,4,12,12,6,5,5,2,1,61,49,110,6,26,5.45454545454545,23.6363636363636,44.5454545454545,55.4545454545455
"56","25","2",6,3,4,4,3,13,5,4,2,5,12,6,4,5,4,8,43,48,91,14,25,15.3846153846154,27.4725274725275,52.7472527472527,47.2527472527473
"57","25","3",0,2,1,6,4,12,9,7,2,5,14,10,3,13,7,23,42,79,121,23,26,19.0082644628099,21.4876033057851,65.2892561983471,34.7107438016529
"58","25","4",4,7,22,2,18,99,8,4,7,17,95,9,6,6,4,3,165,149,314,7,194,2.22929936305732,61.7834394904459,47.4522292993631,52.5477707006369
"59","25","5",0,18,31,2,25,412,5,10,18,15,406,13,8,7,10,1,505,479,984,1,818,0.101626016260163,83.130081300813,48.6788617886179,51.3211382113821
"60","25","6",0,7,24,0,24,411,14,5,7,17,411,19,0,19,5,1,486,481,967,1,822,0.103412616339193,85.005170630817,49.741468459152,50.258531540848
"61","26","1",0,0,2,5,4,6,6,12,0,7,8,13,3,15,12,29,35,90,125,29,14,23.2,11.2,72,28
"62","26","2",0,0,0,0,0,0,0,4,0,0,0,4,1,4,5,89,6,104,110,89,0,80.9090909090909,0,94.5454545454545,5.45454545454545
"63","26","3",0,1,1,3,2,12,3,10,1,3,12,10,2,10,9,21,32,71,103,21,24,20.3883495145631,23.3009708737864,68.9320388349515,31.0679611650485
"64","26","4",0,2,1,2,0,7,2,9,2,1,6,9,3,8,9,41,23,82,105,41,13,39.0476190476191,12.3809523809524,78.0952380952381,21.9047619047619
"65","26","5",1,1,2,1,2,9,6,9,1,1,9,14,0,14,9,32,32,82,114,33,18,28.9473684210526,15.7894736842105,71.9298245614035,28.0701754385965
"66","26","6",0,0,0,2,0,4,1,7,0,2,4,6,2,6,7,47,14,77,91,47,8,51.6483516483516,8.79120879120879,84.6153846153846,15.3846153846154
"67","27","1",2,3,1,4,2,2,4,1,3,2,3,1,3,1,0,19,19,35,54,21,5,38.8888888888889,9.25925925925926,64.8148148148148,35.1851851851852
"68","27","2",0,0,0,1,0,0,1,4,0,1,0,4,1,4,4,56,6,73,79,56,0,70.8860759493671,0,92.4050632911392,7.59493670886076
"69","27","3",0,0,0,0,0,0,0,7,0,0,0,7,0,7,7,45,7,69,76,45,0,59.2105263157895,0,90.7894736842105,9.21052631578947
"70","27","4",0,0,0,2,0,0,1,6,0,1,0,5,1,5,5,60,9,80,89,60,0,67.4157303370787,0,89.8876404494382,10.1123595505618
"71","27","5",0,0,2,1,2,2,3,7,0,3,2,9,1,9,8,32,18,66,84,32,4,38.0952380952381,4.76190476190476,78.5714285714286,21.4285714285714
"72","27","6",1,1,3,2,3,10,2,9,1,4,10,9,2,8,8,54,31,99,130,55,20,42.3076923076923,15.3846153846154,76.1538461538462,23.8461538461538
"73","28","1",11,8,9,8,11,10,5,6,8,9,13,3,6,6,6,4,70,56,126,15,23,11.9047619047619,18.2539682539683,44.4444444444444,55.5555555555556
"74","28","2",5,4,4,4,6,6,3,8,4,4,8,7,2,8,7,6,40,49,89,11,14,12.3595505617978,15.7303370786517,55.0561797752809,44.9438202247191
"75","28","3",0,1,2,6,3,1,0,5,1,7,2,0,4,1,5,3,19,25,44,3,3,6.81818181818182,6.81818181818182,56.8181818181818,43.1818181818182
"76","28","4",0,1,0,2,1,2,1,5,0,1,3,4,0,5,5,13,13,33,46,13,5,28.2608695652174,10.8695652173913,71.7391304347826,28.2608695652174
"77","28","5",0,0,3,1,2,2,1,1,0,4,1,1,2,0,2,2,11,14,25,2,3,8,12,56,44
"78","28","6",0,0,0,1,1,2,2,3,0,1,3,4,0,5,4,7,10,26,36,7,5,19.4444444444444,13.8888888888889,72.2222222222222,27.7777777777778
"79","29","1",2,1,1,3,2,24,6,6,1,3,25,9,2,10,6,29,45,88,133,31,49,23.3082706766917,36.8421052631579,66.1654135338346,33.8345864661654
"80","29","2",0,2,3,5,4,13,3,10,2,6,14,8,4,8,10,18,41,72,113,18,27,15.929203539823,23.8938053097345,63.716814159292,36.283185840708
"81","29","3",2,4,5,3,3,4,8,7,4,4,2,11,5,9,6,8,36,52,88,10,6,11.3636363636364,6.81818181818182,59.0909090909091,40.9090909090909
"82","29","4",1,3,5,1,3,6,2,5,3,3,4,5,4,3,5,3,28,31,59,4,10,6.77966101694915,16.9491525423729,52.5423728813559,47.4576271186441
"83","29","5",0,2,4,6,5,4,5,4,2,8,5,3,5,4,4,4,32,36,68,4,9,5.88235294117647,13.2352941176471,52.9411764705882,47.0588235294118
"84","29","6",0,3,4,3,3,8,3,4,3,4,7,4,4,2,3,3,28,33,61,3,15,4.91803278688525,24.5901639344262,54.0983606557377,45.9016393442623
"85","3","1",0,2,3,7,2,8,7,7,2,7,7,7,7,7,7,17,37,63,100,17,15,17,15,63,37
"86","3","2",0,1,1,0,0,3,1,6,1,0,2,7,1,6,7,13,13,39,52,13,5,25,9.61538461538461,75,25
"87","3","3",0,0,0,1,0,0,1,0,0,2,0,0,2,0,1,6,4,12,16,6,0,37.5,0,75,25
"88","3","4",0,0,1,0,1,1,0,1,0,1,1,2,0,1,1,0,5,8,13,0,2,0,15.3846153846154,61.5384615384615,38.4615384615385
"89","3","5",0,0,0,1,1,1,1,3,0,1,2,3,0,5,3,2,8,18,26,2,3,7.69230769230769,11.5384615384615,69.2307692307692,30.7692307692308
"90","3","6",2,1,1,2,2,1,2,3,1,2,2,3,1,5,4,11,15,31,46,13,3,28.2608695652174,6.52173913043478,67.3913043478261,32.6086956521739
"91","30","1",17,8,4,6,3,7,13,6,8,2,6,12,8,11,6,8,66,62,128,25,13,19.53125,10.15625,48.4375,51.5625
"92","30","2",8,4,3,2,3,5,2,1,4,1,5,1,3,0,1,2,30,18,48,10,10,20.8333333333333,20.8333333333333,37.5,62.5
"93","30","3",19,5,8,2,7,5,3,1,5,5,4,2,3,1,1,1,53,22,75,20,9,26.6666666666667,12,29.3333333333333,70.6666666666667
"94","30","4",26,2,2,2,2,3,2,0,3,1,3,0,2,0,0,0,42,9,51,26,6,50.9803921568627,11.7647058823529,17.6470588235294,82.3529411764706
"95","30","5",7,7,8,4,10,13,3,2,7,5,15,1,2,3,2,6,56,42,98,13,28,13.265306122449,28.5714285714286,42.8571428571429,57.1428571428571
"96","30","6",2,1,2,2,1,4,3,5,1,3,4,6,3,5,5,3,22,31,53,5,8,9.43396226415094,15.0943396226415,58.4905660377358,41.5094339622642
"97","36","1",5,5,4,5,6,9,4,7,5,5,11,6,3,8,7,5,47,51,98,10,20,10.2040816326531,20.4081632653061,52.0408163265306,47.9591836734694
"98","36","2",10,5,5,3,5,17,7,3,6,3,16,7,4,6,3,1,58,46,104,11,33,10.5769230769231,31.7307692307692,44.2307692307692,55.7692307692308
"99","36","3",6,5,5,6,6,12,10,4,5,5,13,8,5,9,4,6,56,56,112,12,25,10.7142857142857,22.3214285714286,50,50
"100","36","4",4,3,3,2,4,16,2,3,3,3,17,3,2,4,4,6,39,43,82,10,33,12.1951219512195,40.2439024390244,52.4390243902439,47.5609756097561
"101","36","5",2,4,6,3,7,14,2,7,4,5,14,6,3,6,7,9,47,55,102,11,28,10.7843137254902,27.4509803921569,53.921568627451,46.078431372549
"102","36","6",6,4,4,5,5,7,6,5,4,5,8,6,4,7,5,6,43,47,90,12,15,13.3333333333333,16.6666666666667,52.2222222222222,47.7777777777778
"103","37","1",5,9,13,14,20,28,13,6,8,19,35,5,7,12,6,2,110,95,205,7,63,3.41463414634146,30.7317073170732,46.3414634146341,53.6585365853659
"104","37","2",1,5,11,7,13,47,8,3,5,13,48,4,5,6,3,3,96,89,185,4,95,2.16216216216216,51.3513513513514,48.1081081081081,51.8918918918919
"105","37","3",7,8,21,1,22,26,2,1,8,15,26,2,1,2,1,0,90,56,146,7,52,4.79452054794521,35.6164383561644,38.3561643835616,61.6438356164384
"106","37","4",1,2,8,6,9,35,3,6,2,12,36,3,5,4,6,4,72,73,145,5,71,3.44827586206897,48.9655172413793,50.3448275862069,49.6551724137931
"107","37","5",4,5,6,8,6,17,13,3,5,9,17,8,8,7,3,3,63,62,125,7,34,5.6,27.2,49.6,50.4
"108","37","6",4,6,9,5,10,8,7,3,6,8,9,5,4,6,2,3,52,46,98,7,17,7.14285714285714,17.3469387755102,46.9387755102041,53.0612244897959
"109","38","1",0,2,2,1,1,8,3,13,2,1,7,15,2,13,12,53,30,108,138,53,15,38.4057971014493,10.8695652173913,78.2608695652174,21.7391304347826
"110","38","2",0,2,3,1,1,22,7,25,2,2,20,31,3,30,25,35,62,150,212,35,42,16.5094339622642,19.811320754717,70.7547169811321,29.2452830188679
"111","38","3",0,0,6,1,3,52,14,17,0,7,49,30,4,27,17,17,93,154,247,17,101,6.88259109311741,40.8906882591093,62.3481781376518,37.6518218623482
"112","38","4",0,2,4,2,3,51,20,25,2,4,50,43,3,42,25,9,109,179,288,9,101,3.125,35.0694444444444,62.1527777777778,37.8472222222222
"113","38","5",0,3,7,2,5,84,14,13,3,6,82,24,4,23,13,3,129,160,289,3,166,1.03806228373702,57.439446366782,55.363321799308,44.636678200692
"114","38","6",0,0,2,0,2,70,9,9,0,2,70,18,0,18,9,2,93,121,214,2,140,0.934579439252336,65.4205607476636,56.5420560747664,43.4579439252336
"115","39","1",10,3,5,0,4,6,0,0,2,2,6,0,0,0,0,0,30,11,41,10,12,24.390243902439,29.2682926829268,26.8292682926829,73.1707317073171
"116","39","2",13,4,2,3,2,5,3,1,4,1,5,2,3,1,1,1,34,20,54,14,10,25.9259259259259,18.5185185185185,37.037037037037,62.962962962963
"117","39","3",4,4,6,1,4,5,3,0,5,2,3,2,3,0,0,0,30,15,45,4,8,8.88888888888889,17.7777777777778,33.3333333333333,66.6666666666667
"118","39","4",4,2,2,1,2,2,1,0,2,0,2,1,0,1,0,0,15,8,23,4,4,17.3913043478261,17.3913043478261,34.7826086956522,65.2173913043478
"119","39","5",7,4,3,1,4,2,1,0,4,1,2,0,1,0,0,0,24,9,33,7,4,21.2121212121212,12.1212121212121,27.2727272727273,72.7272727272727
"120","39","6",2,2,3,0,3,5,0,0,2,1,6,0,0,0,0,0,17,10,27,2,11,7.40740740740741,40.7407407407407,37.037037037037,62.962962962963
"121","4","1",1,3,2,6,2,5,4,9,2,5,5,7,5,7,8,42,32,84,116,43,10,37.0689655172414,8.62068965517241,72.4137931034483,27.5862068965517
"122","4","2",4,3,0,6,0,0,3,12,3,3,1,9,6,10,13,29,30,75,105,33,1,31.4285714285714,0.952380952380952,71.4285714285714,28.5714285714286
"123","4","3",1,3,2,1,1,4,1,4,3,0,3,4,2,3,4,20,17,42,59,21,7,35.5932203389831,11.864406779661,71.1864406779661,28.8135593220339
"124","4","4",0,1,1,2,0,8,5,6,1,2,7,9,2,8,5,4,23,41,64,4,15,6.25,23.4375,64.0625,35.9375
"125","4","5",1,1,2,1,1,2,2,4,1,2,1,4,2,3,3,9,14,28,42,10,3,23.8095238095238,7.14285714285714,66.6666666666667,33.3333333333333
"126","4","6",1,4,3,3,1,5,6,3,4,2,3,5,5,4,3,8,27,36,63,9,8,14.2857142857143,12.6984126984127,57.1428571428571,42.8571428571429
"127","40","1",29,4,8,5,8,7,7,6,4,9,7,8,6,7,6,16,76,64,140,45,14,32.1428571428571,10,45.7142857142857,54.2857142857143
"128","40","2",39,16,16,3,16,9,4,0,16,3,9,1,3,1,0,0,106,33,139,39,18,28.0575539568345,12.9496402877698,23.7410071942446,76.2589928057554
"129","40","3",19,9,9,2,8,1,3,0,8,2,1,1,2,1,0,0,53,16,69,19,2,27.536231884058,2.89855072463768,23.1884057971014,76.8115942028985
"130","40","4",8,4,6,4,5,5,4,1,4,6,4,1,5,1,1,0,38,24,62,8,9,12.9032258064516,14.5161290322581,38.7096774193548,61.2903225806452
"131","40","5",8,5,4,1,4,0,0,1,5,0,1,0,1,0,1,3,25,12,37,11,1,29.7297297297297,2.7027027027027,32.4324324324324,67.5675675675676
"132","40","6",4,3,4,1,4,1,2,1,3,2,1,2,1,2,1,0,23,12,35,4,2,11.4285714285714,5.71428571428571,34.2857142857143,65.7142857142857
"133","41","1",1,3,3,5,2,4,4,11,3,5,3,10,7,9,12,18,35,68,103,19,7,18.4466019417476,6.79611650485437,66.0194174757282,33.9805825242718
"134","41","2",6,4,4,4,2,10,9,5,4,4,8,10,6,8,6,5,45,53,98,11,18,11.2244897959184,18.3673469387755,54.0816326530612,45.9183673469388
"135","41","3",4,7,6,5,9,6,5,7,8,4,9,7,3,9,7,9,52,56,108,13,15,12.037037037037,13.8888888888889,51.8518518518519,48.1481481481481
"136","41","4",3,4,4,7,5,2,5,7,4,7,3,4,6,5,6,11,37,49,86,14,5,16.2790697674419,5.81395348837209,56.9767441860465,43.0232558139535
"137","41","5",7,5,5,4,5,4,6,5,5,4,4,7,4,7,5,8,42,46,88,15,8,17.0454545454545,9.09090909090909,52.2727272727273,47.7272727272727
"138","41","6",3,4,5,3,1,9,4,7,4,4,5,8,7,5,7,3,37,45,82,6,14,7.31707317073171,17.0731707317073,54.8780487804878,45.1219512195122
"139","48","1",12,7,14,1,13,18,1,0,6,8,17,0,1,0,0,0,67,34,101,12,35,11.8811881188119,34.6534653465347,33.6633663366337,66.3366336633663
"140","48","2",16,7,6,7,6,10,4,5,6,6,10,3,6,3,5,7,62,48,110,23,20,20.9090909090909,18.1818181818182,43.6363636363636,56.3636363636364
"141","48","3",0,3,4,5,3,6,8,9,3,6,5,11,6,11,9,13,39,66,105,13,11,12.3809523809524,10.4761904761905,62.8571428571429,37.1428571428571
"142","48","4",0,4,7,4,8,7,3,6,4,7,8,5,4,6,7,5,41,47,88,5,15,5.68181818181818,17.0454545454545,53.4090909090909,46.5909090909091
"143","48","5",0,2,3,4,5,11,5,10,2,5,12,11,2,12,9,15,40,71,111,15,23,13.5135135135135,20.7207207207207,63.963963963964,36.036036036036
"144","48","6",0,1,2,2,3,8,2,4,1,3,9,4,2,5,5,7,24,37,61,7,17,11.4754098360656,27.8688524590164,60.655737704918,39.344262295082
"145","49","1",0,1,5,6,5,19,11,8,1,10,19,13,6,14,9,10,56,84,140,10,38,7.14285714285714,27.1428571428571,60,40
"146","49","2",1,2,1,7,3,15,8,12,3,6,17,13,6,14,12,74,52,145,197,75,32,38.0710659898477,16.243654822335,73.6040609137056,26.3959390862944
"147","49","3",0,5,8,1,9,161,13,28,5,4,162,41,0,41,28,21,226,304,530,21,323,3.9622641509434,60.9433962264151,57.3584905660377,42.6415094339623
"148","49","4",1,2,4,3,5,250,30,34,2,5,251,61,2,62,34,9,330,428,758,10,501,1.31926121372032,66.0949868073879,56.4643799472296,43.5356200527704
"149","49","5",1,6,17,0,17,364,32,29,6,11,363,61,0,61,29,2,467,535,1002,3,727,0.29940119760479,72.5548902195609,53.3932135728543,46.6067864271457
"150","49","6",0,7,34,0,33,427,37,18,7,27,427,55,1,54,18,1,558,591,1149,1,854,0.0870322019147084,74.325500435161,51.4360313315927,48.5639686684073
"151","5","1",41,11,12,1,12,2,0,2,11,2,3,1,1,1,2,1,83,23,106,42,5,39.622641509434,4.71698113207547,21.6981132075472,78.3018867924528
"152","5","2",60,7,5,2,6,0,2,0,8,0,1,0,2,0,0,0,85,11,96,60,1,62.5,1.04166666666667,11.4583333333333,88.5416666666667
"153","5","3",10,6,6,3,7,9,3,1,5,4,10,1,2,2,1,0,47,26,73,10,19,13.6986301369863,26.027397260274,35.6164383561644,64.3835616438356
"154","5","4",14,9,10,4,10,0,2,2,8,5,1,0,3,1,2,0,53,21,74,14,1,18.9189189189189,1.35135135135135,28.3783783783784,71.6216216216216
"155","5","5",3,5,5,2,4,5,3,0,4,2,4,1,2,1,0,0,28,16,44,3,9,6.81818181818182,20.4545454545455,36.3636363636364,63.6363636363636
"156","5","6",8,3,3,2,3,3,1,1,3,2,3,0,2,1,2,1,25,16,41,9,6,21.9512195121951,14.6341463414634,39.0243902439024,60.9756097560976
"157","50","1",0,7,8,5,7,9,6,7,7,6,8,9,6,8,7,16,50,69,119,16,17,13.4453781512605,14.2857142857143,57.9831932773109,42.0168067226891
"158","50","2",5,4,3,5,4,8,6,9,4,4,10,10,4,11,9,18,46,71,117,23,18,19.6581196581197,15.3846153846154,60.6837606837607,39.3162393162393
"159","50","3",3,2,4,3,2,11,3,11,2,5,9,11,6,9,12,11,41,66,107,14,20,13.0841121495327,18.6915887850467,61.6822429906542,38.3177570093458
"160","50","4",0,1,2,4,2,9,4,10,1,5,8,10,4,9,9,12,32,61,93,12,17,12.9032258064516,18.2795698924731,65.5913978494624,34.4086021505376
"161","50","5",0,2,1,3,1,3,4,4,2,2,3,4,3,4,4,3,19,27,46,3,6,6.52173913043478,13.0434782608696,58.695652173913,41.304347826087
"162","50","6",1,3,3,5,3,4,3,6,3,5,4,4,5,3,6,10,29,42,71,11,8,15.4929577464789,11.2676056338028,59.1549295774648,40.8450704225352
"163","51","1",7,7,12,7,8,10,13,4,6,13,6,10,11,6,4,0,70,57,127,7,16,5.51181102362205,12.5984251968504,44.8818897637795,55.1181102362205
"164","51","2",7,5,12,5,12,16,7,1,5,12,16,3,5,3,1,3,67,49,116,10,32,8.62068965517241,27.5862068965517,42.2413793103448,57.7586206896552
"165","51","3",0,2,6,5,3,19,9,4,2,8,16,8,8,5,4,8,50,60,110,8,35,7.27272727272727,31.8181818181818,54.5454545454545,45.4545454545455
"166","51","4",4,4,6,10,7,8,11,4,4,12,9,6,8,7,4,0,55,52,107,4,17,3.73831775700935,15.8878504672897,48.5981308411215,51.4018691588785
"167","51","5",10,3,3,1,3,7,2,4,3,1,7,5,1,5,4,3,35,30,65,13,14,20,21.5384615384615,46.1538461538462,53.8461538461538
"168","51","6",5,3,3,1,4,3,2,3,3,2,4,4,1,5,4,5,26,29,55,10,7,18.1818181818182,12.7272727272727,52.7272727272727,47.2727272727273
"169","52","1",15,13,16,6,13,20,6,9,13,10,17,9,10,5,9,9,100,83,183,24,37,13.1147540983607,20.2185792349727,45.3551912568306,54.6448087431694
"170","52","2",4,14,18,10,19,94,13,13,14,13,95,17,8,18,13,4,186,184,370,8,189,2.16216216216216,51.0810810810811,49.7297297297297,50.2702702702703
"171","52","3",1,11,22,3,23,314,12,9,11,13,315,18,1,20,9,3,396,392,788,4,629,0.50761421319797,79.8223350253807,49.746192893401,50.253807106599
"172","52","4",0,6,9,1,10,427,6,9,6,4,427,14,0,15,9,0,469,477,946,0,854,0,90.2748414376321,50.4228329809725,49.5771670190275
"173","52","5",0,6,17,0,17,737,7,3,6,11,737,10,0,10,3,0,788,779,1567,0,1474,0,94.0650925335035,49.7128270580727,50.2871729419273
"174","52","6",0,3,25,0,25,1043,21,2,3,22,1042,23,0,23,2,0,1120,1117,2237,0,2085,0,93.2051855163165,49.9329459097005,50.0670540902995
"175","54","1",6,6,4,3,1,16,5,3,6,1,14,5,6,2,3,2,46,40,86,8,30,9.30232558139535,34.8837209302326,46.5116279069767,53.4883720930233
"176","54","2",0,2,1,2,2,6,1,1,2,2,7,0,2,1,2,5,17,22,39,5,13,12.8205128205128,33.3333333333333,56.4102564102564,43.5897435897436
"177","54","3",1,2,2,1,2,7,1,0,1,1,8,0,0,1,0,0,18,12,30,1,15,3.33333333333333,50,40,60
"178","54","4",0,1,2,4,2,5,4,3,1,5,6,3,4,3,3,1,23,27,50,1,11,2,22,54,46
"179","54","5",1,1,2,1,1,9,3,2,1,2,8,4,1,4,2,2,21,26,47,3,17,6.38297872340426,36.1702127659574,55.3191489361702,44.6808510638298
"180","54","6",0,1,3,5,5,12,4,2,1,7,14,1,3,3,2,2,33,35,68,2,26,2.94117647058824,38.2352941176471,51.4705882352941,48.5294117647059
"181","59","1",6,8,11,8,7,12,8,5,8,10,9,5,11,2,5,4,67,55,122,10,21,8.19672131147541,17.2131147540984,45.0819672131148,54.9180327868852
"182","59","2",7,5,11,2,10,11,5,1,5,7,10,4,2,3,1,0,53,34,87,7,21,8.04597701149425,24.1379310344828,39.0804597701149,60.9195402298851
"183","59","3",5,5,9,3,6,20,4,2,4,7,18,3,5,1,2,0,56,41,97,5,38,5.15463917525773,39.1752577319588,42.2680412371134,57.7319587628866
"184","59","4",6,6,5,5,6,11,8,2,6,4,13,5,4,6,2,0,51,41,92,6,24,6.52173913043478,26.0869565217391,44.5652173913044,55.4347826086956
"185","59","5",10,4,3,4,6,16,3,2,5,3,19,1,2,3,2,3,51,38,89,13,35,14.6067415730337,39.3258426966292,42.6966292134831,57.3033707865169
"186","59","6",4,1,2,2,2,5,4,4,1,3,5,6,2,6,4,4,26,32,58,8,10,13.7931034482759,17.2413793103448,55.1724137931034,44.8275862068966
"187","61","1",24,9,7,7,8,17,5,4,9,5,18,2,6,3,4,4,84,51,135,28,35,20.7407407407407,25.9259259259259,37.7777777777778,62.2222222222222
"188","61","2",49,16,17,3,17,5,3,0,16,4,5,0,3,0,0,0,112,29,141,49,10,34.7517730496454,7.09219858156028,20.5673758865248,79.4326241134752
"189","61","3",25,15,20,4,20,5,4,1,15,9,5,1,4,1,1,0,96,37,133,25,10,18.796992481203,7.5187969924812,27.8195488721805,72.1804511278196
"190","61","4",21,11,16,3,13,10,6,1,10,8,8,4,5,2,1,0,83,39,122,21,18,17.2131147540984,14.7540983606557,31.9672131147541,68.0327868852459
"191","61","5",8,8,8,4,11,16,2,4,8,4,19,2,1,5,4,0,63,44,107,8,35,7.47663551401869,32.7102803738318,41.1214953271028,58.8785046728972
"192","61","6",3,9,11,5,13,34,4,6,9,7,37,5,3,7,6,0,87,75,162,3,71,1.85185185185185,43.8271604938272,46.2962962962963,53.7037037037037
"193","62","1",8,7,16,4,14,16,10,7,7,13,14,13,5,12,7,6,83,79,162,14,30,8.64197530864197,18.5185185185185,48.7654320987654,51.2345679012346
"194","62","2",3,8,11,4,11,51,4,1,8,7,51,1,3,2,1,0,94,75,169,3,102,1.77514792899408,60.3550295857988,44.3786982248521,55.6213017751479
"195","62","3",1,2,8,1,8,60,3,0,2,7,60,1,1,2,0,0,84,75,159,1,120,0.628930817610063,75.4716981132076,47.1698113207547,52.8301886792453
"196","62","4",1,1,5,4,7,54,7,0,1,7,56,3,1,6,0,0,80,76,156,1,110,0.641025641025641,70.5128205128205,48.7179487179487,51.2820512820513
"197","62","5",0,0,1,0,1,43,5,1,0,1,42,6,0,6,1,0,52,58,110,0,85,0,77.2727272727273,52.7272727272727,47.2727272727273
"198","62","6",0,1,2,0,2,46,0,0,1,1,45,0,0,0,0,0,52,49,101,0,91,0,90.0990099009901,48.5148514851485,51.4851485148515
"199","64","1",0,1,1,1,0,2,0,2,1,1,2,1,1,1,2,2,9,12,21,2,4,9.52380952380952,19.047619047619,57.1428571428571,42.8571428571429
"200","64","2",1,3,1,2,2,14,3,0,2,1,15,1,1,2,0,0,28,23,51,1,29,1.96078431372549,56.8627450980392,45.0980392156863,54.9019607843137
"201","64","3",0,0,2,1,1,63,3,0,0,3,62,2,1,1,0,0,71,71,142,0,125,0,88.0281690140845,50,50
"202","64","4",0,3,4,1,4,68,0,1,2,2,69,0,0,1,1,0,83,76,159,0,137,0,86.1635220125786,47.7987421383648,52.2012578616352
"203","64","5",0,0,1,1,1,134,4,2,0,2,134,5,1,5,2,0,144,151,295,0,268,0,90.8474576271186,51.1864406779661,48.8135593220339
"204","64","6",0,0,1,0,0,85,1,0,0,1,84,1,1,0,0,0,89,88,177,0,169,0,95.4802259887006,49.7175141242938,50.2824858757062
"205","69","1",2,4,5,6,4,9,7,6,4,8,8,7,8,6,6,7,45,55,100,9,17,9,17,55,45
"206","69","2",2,4,6,2,4,12,3,5,4,4,11,5,4,4,5,8,40,46,86,10,23,11.6279069767442,26.7441860465116,53.4883720930233,46.5116279069767
"207","69","3",0,0,0,4,2,9,8,3,0,4,11,7,3,9,4,7,28,46,74,7,20,9.45945945945946,27.027027027027,62.1621621621622,37.8378378378378
"208","69","4",8,7,5,3,4,3,8,2,7,2,2,6,5,5,2,2,42,32,74,10,5,13.5135135135135,6.75675675675676,43.2432432432432,56.7567567567568
"209","69","5",0,1,1,1,1,5,1,3,2,1,5,3,2,3,4,8,16,28,44,8,10,18.1818181818182,22.7272727272727,63.6363636363636,36.3636363636364
"210","69","6",0,1,2,1,3,8,1,1,1,2,10,1,0,2,1,1,19,19,38,1,18,2.63157894736842,47.3684210526316,50,50
"211","71","1",0,1,2,0,2,8,1,1,1,1,7,2,0,2,1,1,16,17,33,1,15,3.03030303030303,45.4545454545455,51.5151515151515,48.4848484848485
"212","71","2",0,1,2,0,2,35,1,1,1,1,35,2,0,2,1,0,44,43,87,0,70,0,80.4597701149425,49.4252873563218,50.5747126436782
"213","71","3",0,1,1,0,1,27,0,1,1,0,27,1,0,1,1,0,32,33,65,0,54,0,83.0769230769231,50.7692307692308,49.2307692307692
"214","71","4",0,0,1,0,2,13,0,0,1,1,13,0,0,0,0,0,19,15,34,0,26,0,76.4705882352941,44.1176470588235,55.8823529411765
"215","71","5",0,0,0,1,1,6,1,0,0,1,7,0,0,1,0,0,10,11,21,0,13,0,61.9047619047619,52.3809523809524,47.6190476190476
"216","71","6",0,0,0,0,0,11,1,2,0,0,10,3,0,3,2,1,15,21,36,1,21,2.77777777777778,58.3333333333333,58.3333333333333,41.6666666666667
"217","73","1",12,8,7,5,6,8,6,4,8,4,7,5,6,4,4,3,57,43,100,15,15,15,15,43,57
"218","73","2",1,11,14,9,17,154,11,7,11,12,158,9,6,12,7,2,226,218,444,3,312,0.675675675675676,70.2702702702703,49.0990990990991,50.9009009009009
"219","73","3",4,13,15,5,15,122,7,9,13,7,123,11,5,11,9,1,192,181,373,5,245,1.34048257372654,65.6836461126005,48.5254691689008,51.4745308310992
"220","73","4",3,5,8,3,4,49,7,6,5,6,46,10,7,6,6,0,87,87,174,3,95,1.72413793103448,54.5977011494253,50,50
"221","73","5",1,5,8,0,8,71,0,4,5,4,71,4,1,3,4,1,99,94,193,2,142,1.03626943005181,73.5751295336788,48.7046632124352,51.2953367875648
"222","73","6",0,2,3,0,1,101,4,3,2,1,98,7,2,5,3,0,115,120,235,0,199,0,84.6808510638298,51.063829787234,48.936170212766
"223","74","1",25,10,10,5,10,6,5,3,10,5,6,3,5,3,3,1,77,36,113,26,12,23.0088495575221,10.6194690265487,31.858407079646,68.141592920354
"224","74","2",20,13,11,6,10,9,4,6,13,4,9,4,6,4,6,5,81,52,133,25,18,18.796992481203,13.5338345864662,39.0977443609023,60.9022556390977
"225","74","3",26,7,9,3,8,9,4,2,8,5,8,3,4,2,2,3,71,35,106,29,17,27.3584905660377,16.0377358490566,33.0188679245283,66.9811320754717
"226","74","4",16,11,15,2,16,2,2,1,11,6,4,0,1,2,1,0,67,26,93,16,6,17.2043010752688,6.45161290322581,27.9569892473118,72.0430107526882
"227","74","5",18,10,9,3,10,5,1,2,10,2,5,0,3,0,2,1,60,24,84,19,10,22.6190476190476,11.9047619047619,28.5714285714286,71.4285714285714
"228","74","6",2,4,7,6,10,6,10,5,4,9,9,9,3,12,5,8,52,60,112,10,15,8.92857142857143,13.3928571428571,53.5714285714286,46.4285714285714
"229","76","1",18,14,17,5,15,14,7,1,13,8,13,3,6,2,1,0,93,47,140,18,27,12.8571428571429,19.2857142857143,33.5714285714286,66.4285714285714
"230","76","2",27,16,17,6,15,19,10,2,16,6,18,6,7,5,2,1,114,62,176,28,37,15.9090909090909,21.0227272727273,35.2272727272727,64.7727272727273
"231","76","3",18,16,16,5,14,37,4,5,16,5,35,5,6,3,5,2,116,79,195,20,72,10.2564102564103,36.9230769230769,40.5128205128205,59.4871794871795
"232","76","4",14,9,10,5,11,8,6,2,9,6,9,3,4,5,3,4,66,45,111,18,17,16.2162162162162,15.3153153153153,40.5405405405405,59.4594594594595
"233","76","5",7,6,9,2,8,13,6,2,5,5,12,6,2,5,1,5,53,44,97,12,25,12.3711340206186,25.7731958762887,45.360824742268,54.639175257732
"234","76","6",3,2,0,5,3,10,5,7,2,3,13,7,2,10,7,9,36,55,91,12,23,13.1868131868132,25.2747252747253,60.4395604395604,39.5604395604396
"235","81","1",12,7,7,4,9,13,4,6,7,4,15,6,2,8,6,27,63,77,140,39,28,27.8571428571429,20,55,45
"236","81","2",3,5,6,9,7,8,12,9,5,10,9,12,8,13,9,9,61,76,137,12,17,8.75912408759124,12.4087591240876,55.4744525547445,44.5255474452555
"237","81","3",0,0,0,2,1,5,6,11,0,1,6,15,0,16,10,37,25,88,113,37,11,32.7433628318584,9.73451327433628,77.8761061946903,22.1238938053097
"238","81","4",0,0,0,2,0,7,3,16,0,2,7,18,2,18,17,70,29,136,165,70,14,42.4242424242424,8.48484848484848,82.4242424242424,17.5757575757576
"239","81","5",0,0,0,3,0,8,1,14,0,3,8,12,3,12,14,75,26,130,156,75,16,48.0769230769231,10.2564102564103,83.3333333333333,16.6666666666667
"240","81","6",0,0,0,4,1,0,4,11,0,4,1,11,3,12,10,55,20,99,119,55,1,46.218487394958,0.840336134453782,83.1932773109244,16.8067226890756
"241","83","1",0,1,1,1,2,1,1,0,1,1,1,0,0,1,0,0,8,6,14,0,2,0,14.2857142857143,42.8571428571429,57.1428571428571
"242","83","2",1,2,2,1,2,1,0,2,2,0,1,1,0,2,2,1,12,11,23,2,2,8.69565217391304,8.69565217391304,47.8260869565217,52.1739130434783
"243","83","3",0,0,0,0,0,17,0,0,0,0,16,0,0,0,0,0,18,18,36,0,33,0,91.6666666666667,50,50
"244","83","4",7,1,1,0,2,5,0,0,2,0,5,0,0,0,0,0,19,7,26,7,10,26.9230769230769,38.4615384615385,26.9230769230769,73.0769230769231
"245","83","5",18,1,1,0,1,0,0,0,1,0,0,0,0,0,0,0,24,1,25,18,0,72,0,4,96
"246","83","6",12,0,0,0,0,0,0,0,0,0,0,0,0,0,0,0,15,0,15,12,0,80,0,0,100
"247","84","1",8,8,8,12,12,212,15,5,8,11,217,8,7,13,5,5,282,275,557,13,429,2.33393177737882,77.0197486535009,49.3716337522442,50.6283662477558
"248","84","2",3,6,6,1,7,214,0,1,5,1,215,0,0,1,1,0,240,224,464,3,429,0.646551724137931,92.4568965517241,48.2758620689655,51.7241379310345
"249","84","3",2,3,4,4,6,16,3,3,3,5,19,2,2,5,3,1,43,41,84,3,35,3.57142857142857,41.6666666666667,48.8095238095238,51.1904761904762
"250","84","4",1,2,3,1,5,5,2,1,2,3,7,1,0,3,1,0,22,18,40,1,12,2.5,30,45,55
"251","84","5",0,2,3,2,5,31,3,1,2,4,33,2,1,4,1,1,49,49,98,1,64,1.02040816326531,65.3061224489796,50,50
"252","84","6",0,2,2,3,5,9,3,0,2,3,11,0,0,3,0,0,25,21,46,0,20,0,43.4782608695652,45.6521739130435,54.3478260869565
"253","85","1",0,4,8,7,8,9,5,7,4,11,10,5,6,6,7,10,50,60,110,10,19,9.09090909090909,17.2727272727273,54.5454545454545,45.4545454545455
"254","85","2",0,3,10,4,6,13,7,4,3,11,10,6,8,3,4,4,49,50,99,4,23,4.04040404040404,23.2323232323232,50.5050505050505,49.4949494949495
"255","85","3",5,7,4,7,5,9,5,7,7,5,9,5,7,5,7,7,51,53,104,12,18,11.5384615384615,17.3076923076923,50.9615384615385,49.0384615384615
"256","85","4",8,5,6,6,6,6,1,9,5,7,6,4,6,4,9,5,48,48,96,13,12,13.5416666666667,12.5,50,50
"257","85","5",5,5,8,4,7,6,7,3,5,7,5,5,6,4,3,3,47,39,86,8,11,9.30232558139535,12.7906976744186,45.3488372093023,54.6511627906977
"258","85","6",5,9,12,6,14,3,5,5,9,9,5,3,5,5,5,2,61,44,105,7,8,6.66666666666667,7.61904761904762,41.9047619047619,58.0952380952381
"259","86","1",2,8,6,9,4,8,13,6,8,8,6,9,12,7,6,9,58,66,124,11,14,8.87096774193548,11.2903225806452,53.2258064516129,46.7741935483871
"260","86","2",1,1,3,5,1,10,7,8,1,8,8,10,8,8,9,6,38,59,97,7,18,7.21649484536082,18.5567010309278,60.8247422680412,39.1752577319588
"261","86","3",0,0,2,4,2,4,5,7,0,6,4,8,4,8,7,13,26,51,77,13,8,16.8831168831169,10.3896103896104,66.2337662337662,33.7662337662338
"262","86","4",0,1,0,4,1,1,0,8,2,3,2,4,4,4,8,9,18,36,54,9,3,16.6666666666667,5.55555555555556,66.6666666666667,33.3333333333333
"263","86","5",0,0,1,1,0,1,1,1,0,2,1,1,2,1,2,1,7,11,18,1,2,5.55555555555556,11.1111111111111,61.1111111111111,38.8888888888889
"264","86","6",6,3,2,2,2,2,1,1,3,1,2,0,1,0,0,0,19,10,29,6,4,20.6896551724138,13.7931034482759,34.4827586206897,65.5172413793103
"265","93","1",0,3,2,6,2,11,11,7,3,5,10,12,6,11,6,13,42,69,111,13,21,11.7117117117117,18.9189189189189,62.1621621621622,37.8378378378378
"266","93","2",8,7,11,4,12,20,9,5,8,8,21,10,4,11,5,8,79,75,154,16,41,10.3896103896104,26.6233766233766,48.7012987012987,51.2987012987013
"267","93","3",13,8,12,5,11,8,8,3,8,9,8,5,6,5,3,2,70,47,117,15,16,12.8205128205128,13.6752136752137,40.1709401709402,59.8290598290598
"268","93","4",3,5,10,4,9,9,6,5,4,9,8,7,4,6,4,4,51,49,100,7,17,7,17,49,51
"269","93","5",1,1,3,1,2,21,7,1,1,3,20,7,2,7,1,0,38,43,81,1,41,1.23456790123457,50.6172839506173,53.0864197530864,46.9135802469136
"270","93","6",3,3,4,1,1,25,5,4,2,2,22,8,3,6,4,6,47,55,102,9,47,8.82352941176471,46.078431372549,53.921568627451,46.078431372549
"271","97","1",6,4,2,8,5,2,9,6,4,7,4,7,6,9,6,2,44,46,90,8,6,8.88888888888889,6.66666666666667,51.1111111111111,48.8888888888889
"272","97","2",4,7,10,7,11,17,7,5,7,10,19,5,6,7,5,0,70,60,130,4,36,3.07692307692308,27.6923076923077,46.1538461538462,53.8461538461538
"273","97","3",1,1,2,0,2,33,3,3,1,1,33,6,1,5,3,1,47,52,99,2,66,2.02020202020202,66.6666666666667,52.5252525252525,47.4747474747475
"274","97","4",0,1,1,1,2,2,3,5,1,1,3,7,0,8,4,6,15,33,48,6,5,12.5,10.4166666666667,68.75,31.25
"275","97","5",0,0,3,1,1,5,1,3,0,4,3,4,3,2,3,2,15,23,38,2,8,5.26315789473684,21.0526315789474,60.5263157894737,39.4736842105263
"276","97","6",0,1,2,2,2,4,2,0,0,3,4,0,2,0,0,0,15,10,25,0,8,0,32,40,60
"277","98","1",0,0,0,0,0,0,0,1,0,0,0,0,0,0,0,2,1,5,6,2,0,33.3333333333333,0,83.3333333333333,16.6666666666667
"278","98","2",3,1,4,0,2,6,3,2,1,3,4,5,3,3,2,2,23,24,47,5,10,10.6382978723404,21.2765957446809,51.063829787234,48.936170212766
"279","98","3",2,3,3,2,1,2,1,5,2,2,0,4,3,2,4,8,19,28,47,10,2,21.2765957446809,4.25531914893617,59.5744680851064,40.4255319148936
"280","98","4",0,1,1,3,1,3,2,4,1,3,3,3,3,3,3,5,15,27,42,5,6,11.9047619047619,14.2857142857143,64.2857142857143,35.7142857142857
"281","98","5",0,0,0,1,0,1,1,2,0,1,1,2,1,1,1,0,5,10,15,0,2,0,13.3333333333333,66.6666666666667,33.3333333333333
"282","98","6",0,0,0,2,1,0,2,1,0,2,1,1,0,2,0,4,6,13,19,4,1,21.0526315789474,5.26315789473684,68.4210526315789,31.5789473684211
